.class	.intro	
.class1.class2	
.class1 .class2	
#id	#firstname	
*	*	
element	p	
element.class	
element,element	
element element	
element>element	
element+element	
element1~element2	
[attribute]	[target]	
[attribute=value]	
[attribute~=value]	
[attribute|=value]	
[attribute^=value]	
[attribute$=value]	
[attribute*=value]	
:active	a:active	
::after	p::after	
::before	p::before	
:checked	input:checked	
:disabled	input:disabled	Selects every disabled <input> element
:default	input:default	
:empty	p:empty	
:enabled	input:enabled	
:first-child	p:first-child	
::first-letter	p::first-letter	
::first-line	p::first-line	
:first-of-type	p:first-of-type	
:focus	input:focus	
:fullscreen	:fullscreen	Selects the element that is in full-screen mode
:hover	a:hover	
:in-range	input:in-range	
:indeterminate	input:indeterminate	
:invalid	input:invalid	
:lang(language)	p:lang(it)	
:last-child	p:last-child	
:last-of-type	p:last-of-type	
:link	a:link	
::marker	::marker	
:not(selector)	:not(p)	
:nth-child(n)	p:nth-child(2)	
:nth-last-child(n)	p:nth-last-child(2)	
:nth-last-of-type(n)	p:nth-last-of-type(2)	
:nth-of-type(n)	p:nth-of-type(2)	
:only-of-type	p:only-of-type	
:only-child	p:only-child	
:optional	input:optional	
:out-of-range	input:out-of-range	
::placeholder	input::placeholder	
:read-only	input:read-only	
:read-write	input:read-write	
:required	input:required	
:root	:root	
::selection	::selection	
:target	#news:target	Selects the current active #news element (clicked on a URL containing that anchor name)
:valid	input:valid	Selects all input elements with a valid value
:visited	a:visited	Selects all visited links










